000000000000000000000000000
000111111111111111111111000
000100000000000000000011000
000100000000010000000001000
000100000000010000000001000
000100000000000000000001000
000100000000010000000001000
000100000000000000000001000
000100000000010000000001000
000100000000010000000P01000
000100000000000000000011000
000111111111111111111111000
000000000000000000000000000