11111111111111111111111111
10000000000000000000000001
100000000000010000000000001
100000000000010000000000001
100000000000010000000000001
100000000000010000000000001
100000000000010000000000001
100000000000010000000000001
100000000000010000000000001
100000000000010000000000001
100000000000010000000000P01
10000000000000000000000001
11111111111111111111111111