
NO ./images/blue_brick_wall.png

SO ./images/arcade_wall.png

EA ./images/moss_wall.png

WE ./images/rock_grey_wall.png

F 90,113,152

C 62,150,188

    1111111111111    111111111111
11111000000000001    1000000001 
1000000000000100111111000000001
1000000E00000100000000000000001
1000000000001100000000000000001
1111100000000100000000000000001
    1000000000000100000000000011111
    1000000000001111000000000000001
    1000000000001  1000000000000001
    1000000000001111111111110000001
    1000000000000100000000000111111
    10000000000000000000000001
    11111111111111111111111111