111111111111111111111111111111111
100000000000000000000000000000001
100000000000000000000000000000001
100000000000000000000000000000001
100000000000000000000000000000001
1000000000000100000000000000000001
1000000000000100000000000000000001
1000000000000100000000000000000001
1000000000000100000000000000000001
1000000000000100000000000000000001
1000000000000100000000000000000001
1000000000000100000000000000000001
1000000000000100000000000000000001
100000000000010000000000P000000001
100000000000000000000000000000001
100000000000000000000000000000001
100000000000000000000000000000001
111111111111111111111111111111111