111111111111111111111
100000000000000000011
101111000010000101001
101001000010000101001
101001000000000101001
101000000010000101001
101001000000000101001
10100100001000010100111111111
101111000010000101P0000000001
10000000000000010100111111111
111111111111111111111