
NO ./images/gold_wall.png

SO ./images/arcade_wall.png

EA ./images/moss_wall.png

WE ./images/rock_grey_wall.png

F 90,113,152

C 62,150,188






          111111111111111    1      1111111111111    11111111111  
          100000000000001    1  11111000000000001    1000000001 
          100000000000001    1  1000000000000100111111000000001
          100000000000001    1  1000000000001000000000000000001
          100000000000001    1  1000000000001100000000000000001
          100000000000001    1  1111100000000100000000000000001
          100000000000001    1      10000E00000001000000000000111111
          100000000000001    1      10000000000011111111111000000001111111
          100000000000001    1      1000000000001         1000000000000001
          100000000000001    1      10000000000011111111111100000011111111
          100000000000001    1      1000000000000100000000000111111
          100000000000001    1      10000000000000000000000001                
          111111111111111    1      11111111111111111111111111