000111111111111111111111000
000100000000000000000011000
000101111000010000101001000
000101001000010000101001000
000101001000000000101001000
000101000000010000101001000
000101001000000000101001000
00010100100001000010100111111111000
000101111000010000101P0000000001000
00010000000000000010100111111111000
000111111111111111111111000