000000000000000000000000000
000111111111111111111111000
000100000000000000000011000
000101011000010000101001000
000101001000010000101001000
000101001000000000101001000
000101000000010000101001000
000101001000000000101001000
000101001000010000101001000
000101111000010000101P01000
000100000000000000101011000
000111111111111111111111000
000000000000000000000000000