111111111111111111111111111
100000000000000000000000011
100000000000010000000000001
100000000000010000000000001
100000000000010000000000001
100000000000000000000000001
100000000000010000000000001
100000000000000000000000001
100000000000010000000000001
100000000000010000000000001
100000000000010000000000P01
100000000000000000000000011
111111111111111111111111111