111111
100001
100P01
100001
111111