NO ./ruta_NO

SO ./ruta_SO

WE ./ruta_WE

EA ./ruta_EA

F 220,100,0

C 225,30,0

    1111111111111    111111111111
11111000000000001    1000000001 1
1000000000000100111111000000001
1000000N00000100000000000000001
1000000000001100000000000000001
1111100000000100000000000000001
    1000000000000100000000000011111
    1000000000001111000000000000001
    1000000000001  1000000000000001
    1000000000001111111111111110001
    1000000000000100000000000111111
    10000000000001000000000001
    11111111111111111111111111