NO ./images/gold_wall.png

SO ./images/arcade_wall.png

EA ./images/moss_wall.png

WE ./images/rock_grey_wall.png

F 90,113,152

C 62,150,188

            1111111111111111111111111111111111111111111111
    N       1000000000000000000000000000000000000000000001
            1000000000000000000000000000000000000000000001
            1000000000000011111100000000000000000000000001
111111111111100000000000001    100000000000000000000000001
100000000000000000000000001    100000000000000000000000001
100000000000000000000000001    100000000000000000000000001
100000000000000000000000011    110000000000000000000000001
100000000000000000000001111    111100000000000000000000001
1000000000000000000001111        1111000000000000000000001
10000000000000000001111            11110000000000000000001
100001111111111111111                111111111111111100001
100001                                              100001
100001                                              100001
100001111111111111111                111111111111111100001
10000000000000000001111            11110000000000000000001
1000000000000000000001111        1111000000000000000000001
100000000000000000000001111    111100000000000000000000001
100000000000000000000000011    110000000000000000000000001
100000000000000000000000001    100000000000000000000000001
100000000000000000000000001    100000000000000000000000001
100000000000000000000000001    100000000000000000000000001
1000000000000000000000000011111100000000000000000000000001
1000000000000000000000000000000000000000000000000000000001
1000000000000000000000000000000000000000000000000000000001
1111111111111111111111111111111111111111111111111111111111