NO ./images/gold_wall.png

SO ./images/arcade_wall.png

EA ./images/moss_wall.png

WE ./images/rock_grey_wall.png

F 90,113,152

C 62,150,188

    1111111111111    11111111111111111111111111       
11111000000000001    1000000000000000000000001   
1000000000000100111111000000000001000000000001 
1000000000001000000000000000000001000000000011   
1000000000001100000000000011111111000000000001
1111100000000100000000000000000000000000000001   
    10000E000000010000000000001111111111111111  
    10000000000011111111111000000001111111
    1000000000001         1000000000000001
    10000000000011111111111000000011111111 
    1000000000000100000000000111111  
    10000000000000000000000001