SO ./images/jmatute-.png
EA ./images/moss_wall.png
WE ./images/rock_grey_wall.png

F    90,113,25        
NO ./images/prueba.png       
C    100,11,85   






111
10111111                                 
1S001 1
11111111