NO ./images/blue_brick_wall.png

SO ./images/blue_brick_wall.png

EA ./images/ice_wall.png

WE ./images/ice_wall.png

F 60,60,60

C 0,175,48

111111111111111111111   111111111111111111111
1E0000000000000000011   110000000000000000001
100000000000000000011   110000000000000000001
100111110011111110011   110011111110011111001
100111110011111110011111110011111110011111001
100000000000000000000000000000000000000000001
100000000000000000000000000000000000000000001
100111110011001111111111111111100110011111001
100000000011000000000111000000000110000000001
100000000011000000000111000000000110000000001
111111110011111111000111000111111110011111111
       1001100000000000000000000011001
       1001100000000000000000000011001
111111110011001111111111111111000110011111111
1000000000000011            11000000000000001
1000000000000011            11000000000000001
111111110011001111111111111111000110011111111
       1001100000000000000000000011001
       1001100000000000000000000011001
111111110011111111000111000111111110011111111
100000000011000000000111000000000110000000001
100000000011000000000111000000000110000000001
100111110011001111111111111111100110011111001
100000000000000000000000000000000000000000001
100000000000000000000000000000000000000000001
100111110011111110011111110011111110011111001
100111110011111110011   110011111110011111001
100000000000000000011   110000000000000000001
100000000000000000011   110000000000000000001
111111111111111111111   111111111111111111111