NO ./images/colors_rock_wall.png

SO ./images/grey_block_wall.png

EA ./images/wall_classic.png

WE ./images/rustic_wall.png

F 214,181,130

C 199,245,250

                   11111111111111111111
                   10000000001000000001
            1111111111111100010001111111111111
        111110001000000000000100010000000010011111
        100000001000011111000100011111000010000111
    11111111100010000100000000000000010000111000011111
    10000110000000000100001111111100010000001000000001
1111100001100000000000000010000001000000000010000000011111
100000001111100011111000001000000100000000001111110E000011
1000011111000000000000000010000001000000000010000000011111
1000000011111000111110000011111111000000000010000000011111
1111100000001100000000000000000000000000001110000001111111
    10000111111100000111110000111100001110000111000001
    11111000011100000000111000000111000010000011011111 
        111100000001000000000000000000000001000001
        111100000000000011111111110000000000011111
           10000110000000000111000000000000001
           11110000000000111111111100000011111
              10001100000000111000000000001
              11111111110000000000001111111
                    11110000000000001111
                    11111111111111111111